Global = CS.FengSheng.LuaManager.Instance.luaEnv.Global

Global.Login = {}
Global.Login.Network = "loginNetwork"
Global.Login.ServerIP = "192.168.31.68"
Global.Login.ServerPort = 8000

Debug = CS.UnityEngine.Debug
Button = CS.UnityEngine.UI.Button
Image = CS.UnityEngine.UI.Image
Text = CS.UnityEngine.UI.Text
Color = CS.UnityEngine.Color
Vector3 = CS.UnityEngine.Vector3
InputField = CS.UnityEngine.UI.InputField
Toggle = CS.UnityEngine.UI.Toggle
WaitForSeconds = CS.UnityEngine.WaitForSecond
Screen = CS.UnityEngine.Screen
HorizontalLayoutGroup = CS.UnityEngine.UI.HorizontalLayoutGroup
ContentSizeFitter = CS.UnityEngine.UI.ContentSizeFitter
RectTransform = CS.UnityEngine.RectTransform
Time = CS.UnityEngine.Time

LoopType = CS.DG.Tweening.LoopType
Ease = CS.DG.Tweening.Ease
RotateMode = CS.DG.Tweening.RotateMode

UIManager = CS.FengSheng.UIManager.Instance
NetManager = CS.FengSheng.NetManager.Instance
EventManager = CS.FengSheng.EventManager.Instance
ProtosManager = CS.FengSheng.ProtosManager.Instance
ResourcesManager = CS.FengSheng.ResourcesManager.Instance
LuaManager = CS.FengSheng.LuaManager.Instance
GameManager = CS.FengSheng.GameManager.Instance
DebugManager = CS.FengSheng.DebugManager.Instance
UIEventManager = CS.FengSheng.UIEventManager.Instance
GameObjectPool = CS.FengSheng.GameObjectPool
Utils = CS.FengSheng.Utils
